ПО - Tarkvara
Процесс разработки ПО - Tarkvara arendusprotsess
Документация на ПО - Tarkvara dokumentatsioon
Проект - Projekt
ИТ проект - IT Projekt
Бизнес-проект - Äriprojekt
Проект по разработке - Arendusprojekt
Проект по реализации - Teostusprojekt
Диаграмма Ганта - Gantti diagramm
UML схема - UML skeem
Диаграмма прецедентов - Kasutusmalliskeem
Диаграмма последовательности - Jadaskeem
Диаграмма состояний - Olekuskeem
Диаграмма активности - Tegevusskeem
Диаграмма классов - Klassiskeem
Диаграмма взаимодействий - Koostooskeem
Схема (диаграмма) баз данных- Andmebaasiskeem
CASE-средства - CASE vahendid
Архитектурная/проектная документация - Arhitektuurne / Projekti dokumentatsioon
Техническая документация - Tehniline dokumentatsioon
Пользовательская документация - Kasutaja dokumentatsioon
Система управления версиями - Versioonihaldussüsteem
Локальное управление - Kohalik juhtimine
Централизованное управление - Tsentraliseeritud juhtimine
Распределенное управление - Harjutatud juhtimine
Критический путь проекта - Projekti kriitiline tee
Аутсорсинг - Outsourcing
Краудсорсинг - Crowdsourcing
IT аудит - IT audit
ERP системы - ERP süsteem
Методики - Meetodid
Каскадная модель - Kaskaadne mudel
Спиральная модель  - Spiraalne mudel
Инкрементальная модель - Inkrementaalne mudel
Прототированная модель - Prototeeritud mudel
V-модель - V-mudel
Агильная модель - Agile mudel
ERP системы - ERP-süsteemi
Cистемы управления базами данных - Andmebaaside haldamise süsteemid
Организация проекта - Projekti korraldamine
Обмен информацией - teabevahetus
Расходы - Kulud
Качество - Kvaliteet
Валидирование - Valideerimine
Служба поддержки - Tugiteenus
lisa veel 10 sõna
